1111111111111111111111111111111
1315551555155555551515555555551
1311151115111115151511111115111
1555555555151515151515555555551
1511151511151511151511151115111
1515551555555555555555151515551
1511111111111511151111151511111
1555555555151515555555155555551
1111111111151115111515151111151
1555555515555515551515555555151
1511111511151115111511111511111
1555155555555555155555151555551
1111151511111511111115151511151
1555551515151515551555151515551
1515151115151515151111151115111
1515151555555555155555555515551
1111111111111111111111111111111
