1111111111111111111111111111111
1550000010101015005024240010501
1010111010101010111011101114101
1012100000140000105010101012101
1112111111141111111110111013111
1000003355005500100010001000151
1011101010111111111010101110101
1010101010105500100300100010501
1515111510111115101010111011101
1510001013001055001010100300101
1511101010111111101111101111101
1000101510101010022010103055501
1011101110101010111110111010101
1000001055000010101003001010101
1110111111101110101111101111101
1055001004444422555005501000001
1111111111111111111111111111111

