1111111111111111111111111111111
1000000010000000101000100000001
1000101110111011101010101111101
1000101000100010100010101000101
1014111110111010101111101110101
1014100000101000001000001000101
1014111011101111101010111110111
1014100016100000001010001010101
1114111110101111111010101010101
1014001333331000144410100210001
1014111011101110141011101210111
1014101010001000121010001200001
1014101011101010131011111011111
1010000010100010121010001000001
1010111010101011131011101111101
1000100000101222221610000000001
1111111111111111111111111111111
