1111111111111111111111111111111
1010001010000000000000001010101
1010111010101011101011111010101
1010000000101000101010001000001
1011111011111010111010111010111
1000000010100010100000000010001
1110111010111111101110111011111
1010001000100000101010101010101
1011101110101110101011101010101
1010100010101000001000100010101
1010101011111111111110101110101
1010101000101010100000100000101
1010101111101010111110111111101
1000101010000000000000100010001
1011101010101011101110101110111
1000000000101010001000000000001
1111111111111111111111111111111
