1111111111111111111111111111111
1414441444144444441412442222441
1411141114111114141411111114111
1442222444141414141414442222441
1411141211141411141411141114111
1414441444244424442444141414441
1411111111111411141111141411111
1442244224141414244424144444441
1111111111141114111414141111141
1444444414444414441414444444141
1411111411141114111411111411111
1444144444444444144444141422441
1111141411111411111114141411141
1444441414141414241444121414441
1414141114141414141111141114111
1414141422442444142242244414441
1111111111111111111111111111111
