1111111111111111111111111111111
1553333333333313333333333333331
1113131111131111111311131111131
1316133333161333331363131313331
1311111311111311111111131313131
1333333633333333131633331313131
1113111313111113131311111311111
1333161313633313331333333313131
1111131113131113131113111113131
1313133333133313131313133313331
1313111311111113111313131113131
1363161313631333131363331333131
1313131313131111131313111311131
1313133313133333333313333313131
1311111311111313111313111113131
1333333333333316133313633333131
1111111111111111111111111111111

