1111111111111111111111111111111
1515551515555555555555551515151
1515111515151511151511111515151
1515555555151555151515551555551
1511111511111515111515111515111
1555555515155515155555555515551
1115111515111111151115111511111
1515551555155555151515151515151
1511151115151115151511151515151
1515155515151555551555155515151
1515151511111111111115151115151
1515151555151515155555155555151
1515151111151515111115111111151
1555151515555555555555155515551
1511151515151511151115151115111
1555555555151515551555555555551
1111111111111111111111111111111
