1111111111111111111111111111111
1555555515151515555555555515551
1515111515151515111511151115151
1515155555155555155515151515151
1115111111151111111115111515111
1555555555555555155515551555151
1511151515111111111515111115151
1515151515155555155555155515551
1515111515111115151515111511151
1515551515551555551515155555151
1511151515111111151111151111151
1555151515151515555515155555551
1511151115151515111115111515151
1555551555555515151555555515151
1115111111151115151111151111151
1555551555555555555555551555551
1111111111111111111111111111111

