1111111111111111111111111111111
1555555555555555555515155515551
1511111515111111151115151115111
1515555515551555155515555555551
1111111511111511111511111115151
1555551555151555155555151555151
1511151511151511151515151111151
1555151555151515151515555555551
1515111511151515111511111511111
1515151555551555155515555555551
1511151115111511151115111511151
1515551555151555151515155555151
1511151515151515111515111115111
1555555515555515551515551555551
1115111115111511111515151115111
1555551555551515555555151555551
1111111111111111111111111111111
