1111111111111111111111111111111
1555555555555515555555555555551
1115151111151111111511151111151
1515155555151555551555151515551
1511111511111511111111151515151
1555555555555555151555551515151
1115111515111115151511111511111
1555151515555515551555555515151
1111151115151115151115111115151
1515155555155515151515155515551
1515111511111115111515151115151
1555151515551555151555551555151
1515151515151111151515111511151
1515155515155555555515555515151
1511111511111515111515111115151
1555555555555515155515555555151
1111111111111111111111111111111

