1111111111111111111111111111111
1555555555553555555515155515551
1511111315111111151115131113111
1515555515551555153515555555551
1111111511111311111511111115131
1555551555151555153555151555151
1511151511151511151515151111151
1555151555151515151515555535551
1515111511151515151511111111111
1515151555551535153515555535551
1511151115111511151115111311151
1515531555151535155515155555151
1511151515151515151515111115111
1555555515555515551515551553551
1115111115111511111515151115111
1553551535551515555555151555551
1111111111111111111111111111111
