1111111111111111111111111111111
1553355515555555151555155555551
1555151115111511151515151111151
1555151555155515155515151555151
1515111115111515151111151115151
1515155445151555551555551555151
1515111511151111151515111115111
1515155515155555551515551515151
1115111115151111111515151515151
1515551555551555155515155515551
1515111511151115151511151515111
1515151515551555151512221555551
1515151511151515151511111511111
1515555515155515151515551555551
1515111515151511151511151111151
1555155555151555551515555555551
1111111111111111111111111111151
