11111111111111111111111111111111
15555555555555555555555555555551
15555555555555555555555555555551
15555555555555555555555555555551
15111522253335444566655555555551
15111522253335444566655555555551
15111522253335444566655555555551
15555555555555555555555555555551
15555555555555555555555555555551
15555555555555555555555555555551
15555555555555555555555555555551
15555555555555555555555555555551
15555555555555555555555555555551
15555555555555555555555555555551
15555555555555555555555555555551
15555555555555555555555555555551
15555555555555555555555555555551
11111111111111111111111111111111