1111111111111111111111111111111
1555555555555555555555555555551
1555555555555555555555555555551
1555555555555555555555555555551
1511152225333544456665555555551
1511152225333544456665555555551
1511152225333544456665555555551
1555555555555555555555555555551
1555555555555555555555555555551
1555555555555555555555555555551
1555555555555555555555555555551
1555555555555555555555555555551
1555555555555555555555555555551
1555555555555555555555555555551
1555555555555555555555555555551
1555555555555555555555555555551
1111111111111111111111111111111
